Level 1
╔═════════════╤╤═════════════╗
║.............││.............║
║.┌──┐.┌────┐.││.┌──┐.┌────┐.║
║●│  │.│    │.││.│  │.│    │●║
║.└──┘.└────┘.└┘.└──┘.└────┘.║
║............................║
║.┌──┐.┌┐.┌────────┐.┌┐.┌──┐.║
║.└──┘.││.└───┐┌───┘.││.└──┘.║
║......││.....││.....││......║
╟────┐.│└───┐ └┘ ┌───┘│.┌────╢
║    │.│┌───┘    └───┐│.│    ║
║    │.││     ☻      ││.│    ║
╨────┘.└┘ ┌───▬▬───┐ └┘.└────╨
      .   │ ☻ ☻ ☻  │   .     
╥────┐.┌┐ └────────┘ ┌┐.┌────╥
║    │.││     ♣      ││.│    ║
║    │.││ ┌────────┐ ││.│    ║
╟────┘.└┘ └───┐┌───┘ └┘.└────╢
║.............││.............║
║.┌──┐.┌────┐.││.┌────┐.┌──┐.║
║.└─┐│.└────┘.└┘.└────┘.│┌─┘.║
║●..││.       @        .││..●║
╟─┐.││.┌┐.┌────────┐.┌┐.││.┌─╢
╟─┘.└┘.││.└───┐┌───┘.││.└┘.└─╢
║......││.....││.....││......║
║.┌────┘└───┐.││.┌───┘└────┐.║
║.└─────────┘.└┘.└─────────┘.║
║............................║
╚════════════════════════════╝